40
20

HHHHHHHHHHHHHHHHHHHHHHHHHHHHHHHHHHHHHHHH
HXXXX X XXXOOOXXXXXXXXXXXOXXXXXXXXXXXXXH
HXXOOXXXXXXXXX XXXXXXXXXXXXOXOXXXX  XXXH
HXXXXXXOXXXXXXXXXXXOOXOXXXXXXXXXXX  XXXH
HX  XXXVXXX  XXXOXXXXXXXXXVXXXXXXXXXXXXH
HXXXXOXXXXXX  XXXXXXXXXXXXXXXXXXXOXXXXXH
HXXXXXXXOOXXXXXXOOOXXXXXX XXXXXOXXXXXXXH
HXXXX X XXXXXXXXXXXXXXXXXXXXOOXX  XXOXXH
HHHHHHHHHHHHXXXOXXXXOXXXXXXXXXXXXXXOOXXH
HXXXXXVOXX XXXXXXXXXXXXXXXXXXOXXXXXXOXXH
HXXXXXOXXXXXXXXXXXOXXXXOXXXXXVOXXXXXXXXH
HHHHHHHHXXXXX  XXXXXXOXXXXXXXXXXXXXXXXXH
HXXXXXXOOOXOOXXXXXXXXXXXXXXXXXHHHHHHHHHH
HXXOOOXXXX XXXXXXXOOXVXXXXXXOXXHHHHHHHHH
HXXXXXXOXXXOOXVXXOOXXXXXXXOXXOXOOXXXXXXH
HOXXVXXXXXOOXXXXXOXXXXXXXXXX XXXXXXXXXXH
HOXXXXXXXHHHHHHHHHHHXXXXXOOXXOOXXXXXXXDH
HXXXOXXXXXXXOXXXVXXXXOOXXXXXXHXOXXXXXXXH
HXXXXXXOXXXXXXXXXXXXXXXXXXXXXHVXXO  XXXH
HHHHHHHHHHHHHHHHHHHHHHHHHHHHHHHHHHHHHHHH