HHHHHHHHHHHHHHHHHHHHHHHHHHHHHHHHHHHHHHHH
HXXXXXXXXXXXXOXXX_XXXXXXXXXXXXXXXXXXXXXH
HXXXXXXXXXXOOOXXX_XXXXXXXOXXXXXXXXXXXXXH
HXXXOXXXXXXXVXXXXXXXXXXXXXXOXOXXXX__XXXH
HXXXVXXOXXOXXXXXXXXXXXXOXXXXXXXXXX__XXXH
HXXX_XXXXX__XXXOXXXXXXXXXXXXX___XXXXXXXH
HXXXXOXXXXXX_XXXXXXXXXXXXOXXXXXXXHHHHHHH
HXXXXXXXOOXXXXXXOXOXXXXXX_XXXXXOXXXXXXXH
HXXXX_X_XXXXXXXXXVX_XXXXXXXXOOXXXXXXOXXH
HHHHHHHHHHHHHHHHHHHHOXXXXXXXXXXXXXXOOXXH
HXXXXXOVXX_XXXXXXXXX_XXXXXXXXOXXXXXXOXXH
HXXXXXXXXXXXXXXXXXOXXXXOXXXXXOXXXXXXXXXH
HXXXXXXXXXXXXXXXXXXXXOXXXXXXXX_XXXXXXXXH
HXXXXXXOOOXXXXXX__XXVXXXXHHHHHHHHHHHHHHH
HXX__XXXXX_XXXXXXXOOXXXXXXXXOXXHHHHHHHHH
HHHHHHHHHXXX_XXOXVXOOXXXXXXXXXXXOXXOXXXH
HOXXXXXXXXOOXXXXXOXXXXXXXXXX_XXXXXOOXXXH
HOXXXXXXXHHHHHHHHHHHXXXXXOOXXOO__XXXXXXH
HXXXOXXXXXXXOXXXXXXXXOXXXXXXXHXOXXXXXXXH
HXXX_XXXXXXX_VXXXXXXXVXXXXXXXHVXXOXXXXXH
HHHHHHHHHHHHHHHHHHHHHHHHHHHHHHHHHHHHHHHH