HHHHHHHHHHHHHHHHHHHHHHHHHHHHHHHHHHHHHHHH
HXXX__XXXXXXXXXXXXXXXXXXXOXXXXXXXXXOXXXH
HXXXXXX_XXXOOOXXXXXXXXXXXOXXXXOOXXXXXXXH
HXXXXXXOXXXXXXXXXXXXXXXXXXXXXX__XXXXXXXH
HXXXXXXXOXXXXXXXXXXXXXXXXXXXXXXXXXXXXXXH
HXXXXXOVXXXXXXXOXXXOOXXOXXXXXXXXXXXXXXXH
HHHHHHHHHHHX_XXXXXXX__XXXX_XXXXOXXXXXXXH
HHHHHHHHOOOXXXXXOXOXXXXXXXXXXXX_XXXXXXXH
HXXXX_X_XXVXXXXXX_XXOXXXXXXXOOXXXXXXOXXH
HOXXXXXXXXXXXXXOXXXX__XXXXXXXVXXXXXOOXXH
HXXXXXOXXX_XXXXXXXOXXXXXXXXXXOXXXXXXOXXH
HXXXXXVXXXXXXXXXXX_XXXXXXXXVOX_XOXXXXXXH
HHHHHHHXXXXXXXXXXXXXOOXXXXXXVX_XXXXXHHHH
HXXXXXOOOXXXXXX__XX___XXOXXXXXX__XHHHHHH
HXX__XXXXX_XXXXXXXOOXXXX_XXXXXXXXHHHHHHH
HXXXXXXXXXXX_XOOXX__OXXXXXXXXXXXOXOOXXXH
HOX__XOXXXOOXXVXVOXX_XXXXXX__XXXX__XXXXH
HHHHHH_XXHHHHHHHHHHHHHHOXXXOOXXOOXOOXXXH
HXXXOXXXXXXXOXXXXXXXXOXXXXXXXXXOXVX_XXXH
HXXX_XXXXXXXXXXXXXXOOXXXXXXXXXXXXXXXXXXH
HHHHHHHHHHHHHHHHHHHHHHHHHHHHHHHHHHHHHHHH