HHHHHHHHHHHHHHHHHHHHHHHHHHHHHHHHHHHHHHHH
HXXXXXXXXXXXXOXXX_XXXXXXXXXXXXXXXXXXXXXH
HXXXXXXXXXXOOOXXX_XXXXXXXOXXXXXXXXXXXXXH
HXXXOXXXXXXXVXXXXXXXXXXXXXXOXOXXXX__XXXH
HXXXVXXOXXOXXXXXXXXXXXXOXXXXXXXXXX__XXXH
HXXX_XXXXXX_XXXOXXXXXXXXXXXXX___XXXXXXXH
HXXXXOXXXX_X_XXXXXXXXXXXXOXXXXXXXHHHHHHH
HXXXXXXXOOXXXXXXOXOXXXXXXX_XXXXOXXXXXXXH
HXXXX_X_XXXXXXXXXVX_XXXXXXXXOOXXXXXXOXXH
HHHHHHHHHHHHHHHHHHHHOXXXXXXXXXXXXXXOOXXH
HXXXXXOVXX_XXXXXXXXXXXXXXXXXXOXXXXXXOXXH
HXXXXXXXXXXXXXXXXXOX_XXOXXXXXOXXXXXXXXXH
HXXXXXXXXXXXXXXXXXXXXOXXXXXXXX_XXXXXXXXH
HXXXXXXOOOXXXXXX__XXVXXXXHHHHHHHHHHHHHHH
HXX__XXXXX_XXXXXXXOOXXXXXXXXOXXHHHHHHHHH
HHHHHHHHHXXX_XXOXVXOOXXXXXXXXXXXOXXOXXXH
HOXXXXXXXXOOXXXXXOXXXXXXXXXX_XXXXXOOXXXH
HOXXXXXXXHHHHHHHHHHHXXXXXOOXXOO__XXXXXXH
HXXXOXXXXXXXOXXXXXXXXOXXXXXXXHXOXXXXXXXH
HXXXXX_XX__XXVXXXXXXXVXXXXXXXHVXXOXXXXXH
HHHHHHHHHHHHHHHHHHHHHHHHHHHHHHHHHHHHHHHH