HHHHHHHHHHHHHHHHHHHHHHHHHHHHHHHHHHHHHHHH
HXXOOXXXXX__XXXXXXXOXXXXXXXXXXXXXXXXXXXH
HXXXXXXXXXXXXXXXXXXXXXXXXXXXXXXXXXXXXXXH
HXXXXXXXXXXXXXXXOXXXXXXXOOXXXXXXXXXXXXXH
HXXXXXXXXXXXXXX__XXXXXXXXXXXHHHHHHHHHHHH
HOOOXOOXXXXXXXXXXXXXXXXXXXXOOXXXXXOOXXXH
HXXXX__XXOOXXXXHHHHHHHHHXXXXXXXXXXXXXXXH
HXXXXXXXXXXXXXXX__XXXXXOO_XXXXXXX__OOXXH
HHHHHHHXXXXXXXXXXXXXXXXXXXXXXXOXXXXXXXXH
HXXXXXXXX__OXXXXXX_YXOOXXX__XXXXXXXXXXXH
HXXXXXXOOXXXXXXXXX__XXXXXXXXXXXXXOOXXXXH
HXXOOXXXXXXXXXXXOOXXOXXOOHHHHHXXXXXXXXXH
HXXXXXX__XXXXXXX__X__XXXXXXXXXXXXXXX__XH
HXXXXXXXXXXXXXXXXXXXXXXX_XXXOXXOOXXXXXXH
HXXXOXXOXXXOOXXXXOOXXXXXXXOXXOX__XXXXXXH
HOXXXXX_XXOOXXX_XOXXXXXXXXXX_XXXXXXXHHHH
HOXXXXXXXHHHHHHHHHHHXXXXXOOXXOOOXXXXXXXH
HXXXOXXXXXXXOXXXXXXXXOOXXXXXXHXOXXXXXXXH
HXXXXXXOXXXXXXO__O_XXXXXXXXXXHXXXXXXXXXH
HXXXXXXOXXXXXXX_XXXXXXXXXXXXXXXXXXXXXXXH
HHHHHHHHHHHHHHHHHHHHHHHHHHHHHHHHHHHHHHHH