HHHHHHHHHHHHHHHHHHHHHHHHHHHHHHHHHHHHHHHH
HHHOOXXXXX__XXXXXXXOXXXXXXXXXXXXXXXXXHdH
reHXXXXXXXXXXXXXXXXXXXXXXXXXXXXXXXXXXHHg
HHHXXXXXXXXXXXXXOXXXXXXXOOXXXXXXXXXXXHHc
HcHXXXXXXXXXXXX__XXXXXXXXXXXHHHHHHHHHHHH
HdHOXOOXXXXXXXXXXXXXXXXXXXXOOXXXXXOOXHiH
HHHXX__XXOOXXXXHHHHHHHHHXXXXXXXXXXXXXHli
HHHXXXXXXXXXXXXX__XXXXXOO_XXXXXXX__OOHHH
irHHHHHXXXXXXXXXXXXXXXXXXXXXXXOXXXXXXHrH
HHHXXXXXX__OXXXXXX_YXOOXXX__XXXXXXXXXHHc
eHHXXXXOOXXXXXXXXX__XXXXXXXXXXXXXOOXXHHl
HiHOOXXXXXXXXXXXOOXXOXXOOHHHHHXXXXXXXHgH
HHHXXXX__XXXXXXX__X__XXXXXXXXXXXXXXX_HHH
HcHXXXXXXXXXXXXXXXXXXXXX_XXXOXXOOXXXXHeH
lHHXOXXOXXXOOXXXXOOXXXXXXXOXXOX__XXXXHHH
HHHXXXX_XXOOXXX_XOXXXXXXXXXX_XXXXXXXHHHH
dlHXXXXXXHHHHHHHHHHHXXXXXOOXXOOOXXXXXHHr
HgHXOXXXXXXXOXXXXXXXXOOXXXXXXHXOXXXXXHHH
HHHXXXXOXXXXXXO__O_XXXXXXXXXXHXXXXXXXHdH
HiHXXXXOXXXXXXX_XXXXXXXXXXXXXXXXXXXXXHHe
HHHHHHHHHHHHHHHHHHHHHHHHHHHHHHHHHHHHHHHH