HHHHHHHHHHHHHHHHHHHHHHHHHHHHHHHHHHHHHHHH
HXXXX_X_XXXOOOXXXXXXXXXXXOXXXXXXXXXXXXXH
HXXOOXXXXXXXXX_XXXXXXXXXXXXOXOXXXX__XXXH
HXXXXXXOXXXXXXXXXXXOOXOXXXXXXXXXXX__XXXH
HX__XXXVXXX__XXXOXXXXXXXXXVXXXXXXXXXXXXH
HXXXXOXXXXXX__XXXXXXXXXXXXXXXXXXXOXXXXXH
HXXXXXXXOOXXXXXXOOOXXXXXX_XXXXXOXXXXXXXH
HXXXXXXXOOXXXXXXOOOXXXXXXXXXXXOXXXXXXXXH
HXXXX_X_XXXXXXXXXXXXXXXXXXXXOOXX__XXOXXH
HHHHHHHHHHHHXXXOXXXXOXXXXXXXXXXXXXXOOXXH
HXXXXXVOXX_XXXXXXXXXXXXXXXXXXOXXXXXXOXXH
HXXXXXOXXXXXXXXXXXOXXXXOXXXXXVOXXXXXXXXH
HHHHHHHHXXXXX__XXXXXXOXXXXXXXXXXXXXXXXXH
HXXXXXXOOOXOOXXXXXXXXXXXXXXXXXHHHHHHHHHH
HXXOOOXXXX_XXXXXXXOOXVXXXXXXOXXHHHHHHHHH
HXXXXXXOXXXOOXVXXOOXXXXXXXOXXOXOOXXXXXXH
HOXXVXXXXXOOXXXXXOXXXXXXXXXX_XXXXXXXXXXH
HOXXXXXXXHHHHHHHHHHHXXXXXOOXXOOXXXXXXXHH
HXXXOXXXXXXXOXXXVXXXXOOXXXXXXHXOXXXXXXXH
HXXXXXXOXXXXXXXXXXXXXXXXXXXXXHVXXO__XXXH
HHHHHHHHHHHHHHHHHHHHHHHHHHHHHHHHHHHHHHHH